Acanthaceae	Acanthaceae
Acanthus	Acanthaceae
Adoxaceae	Adoxaceae
Sambucus	Adoxaceae
Viburnum	Adoxaceae
Amaranthaceae	Amaranthaceae
Chenopodium	Chenopodiaceae
Amaryllidaceae	Amaryllidaceae
Allium	Amaryllidaceae
Anacardiaceae	Anacardiaceae
Cotinus	Anacardiaceae
Rhus	Anacardiaceae
Apiaceae	Apiaceae
Eryngium	Apiaceae
Ferula	Apiaceae
Malabaila	Apiaceae
Lecokia	Apiaceae
Pimpinella	Apiaceae
Asparagaceae	Asparagaceae
Leopoldia	Asparagaceae
Ornithogalum	Asparagaceae
Asteraceae	Asteraceae
Achillea	Asteraceae
Anthemis	Asteraceae
Arctium	Asteraceae
Artemisia	Asteraceae
Bellis	Asteraceae
Carduus	Asteraceae
Centaurea	Asteraceae
Chondrilla	Asteraceae
Cichorium	Asteraceae
Cirsium	Asteraceae
Cota	Asteraceae
Crepis	Asteraceae
Cyanus	Asteraceae
Echinops	Asteraceae
Gundelia	Asteraceae
Helichrysum	Asteraceae
Iranecio	Asteraceae
Matricaria	Asteraceae
Onopordum	Asteraceae
Scorzonera	Asteraceae
Tanacetum	Asteraceae
Taraxacum	Asteraceae
Tussilago	Asteraceae
Xeranthemum	Asteraceae
Helianthus	Asteraceae
Ptilostemon	Asteraceae
Xanthium	Asteraceae
Boraginaceae	Boraginaceae
Alkanna	Boraginaceae
Anchusa	Boraginaceae
Cerinthe	Boraginaceae
Echium	Boraginaceae
Myosotis	Boraginaceae
Phyllocara	Boraginaceae
Brassicaceae	Brassicaceae
Aethionema	Brassicaceae
Capsella	Brassicaceae
Isatis	Brassicaceae
Lepidium	Brassicaceae
Raphanus	Brassicaceae
Campanulaceae	Campanulaceae
Campanula	Campanulaceae
Caprifoliaceae	Caprifoliaceae
Centranthus	Caprifoliaceae
Morina	Caprifoliaceae
Scabiosa	Caprifoliaceae
Cephalaria	Caprifoliaceae
Valeriana	Caprifoliaceae
Caryophyllaceae	Caryophyllaceae
Cerastium	Caryophyllaceae
Saponaria	Caryophyllaceae
Silene	Caryophyllaceae
Dianthus	Caryophyllaceae
Chenopodiaceae	Chenopodiaceae
Convolvulaceae	Convolvulaceae
Convolvulus	Convolvulaceae
Cornaceae	Cornaceae
Cornus	Cornaceae
Crassulaceae	Crassulaceae
Phedimus	Crassulaceae
Elaeagnaceae	Elaeagnaceae
Elaeagnus	Elaeagnaceae
Euphorbiaceae	Euphorbiaceae
Euphorbia	Euphorbiaceae
Fabaceae	Fabaceae
Astracantha	Fabaceae
Astragalus	Fabaceae
Astrgalus	Fabaceae
Colutea	Fabaceae
Genista	Fabaceae
Glycyrrhiza	Fabaceae
Lathyrus	Fabaceae
Lotus	Fabaceae
Hedysarum	Fabaceae
Medicago	Fabaceae
Melilotus	Fabaceae
Onobrychis	Fabaceae
Ononis	Fabaceae
Robinia	Fabaceae
Securigera	Fabaceae
Trifolium	Fabaceae
Vicia	Fabaceae
Coronilla	Fabaceae
Fagaceae	Fagaceae
Quercus	Fagaceae
Geraniaceae	Geraniaceae
Geranium	Geraniaceae
Hypericaceae	Hypericaceae
Hypericum	Hypericaceae
Ixioliriaceae	Ixioliriaceae
Ixiolirion	Ixioliriaceae
Lamiaceae	Lamiaceae
Ajuga	Lamiaceae
Lamium	Lamiaceae
Marrubium	Lamiaceae
Mentha	Lamiaceae
Nepeta	Lamiaceae
Origanum	Lamiaceae
Phlomis	Lamiaceae
Salvia	Lamiaceae
Satureja	Lamiaceae
Stachys	Lamiaceae
Teucrium	Lamiaceae
Thymus	Lamiaceae
Linaceae	Linaceae
Linum	Linaceae
Lythraceae	Lythraceae
Lythrum	Lythraceae
Malvaceae	Malvaceae
Alcea	Malvaceae
Malva	Malvaceae
Tilia	Malvaceae
Moraceae	Moraceae
Morus	Moraceae
Onagraceae	Onagraceae
Epilobium	Onagraceae
Papaveraceae	Papaveraceae
Fumaria	Papaveraceae
Papaver	Papaveraceae
Plantaginaceae	Plantaginaceae
Anarrhinum	Plantaginaceae
Globularia	Plantaginaceae
Lagotis	Plantaginaceae
Linaria	Plantaginaceae
Plantago	Plantaginaceae
Plumbaginaceae	Plumbaginaceae
Acantholimon	Plumbaginaceae
Poaceae	Poaceae
Zea	Poaceae
Polygonaceae	Polygonaceae
Polygonum	Polygonaceae
Rheum	Polygonaceae
Rumex	Polygonaceae
Primulaceae	Primulaceae
Lysimachia	Primulaceae
Portulacaceae	Portulacaceae
Portulaca	Portulacaceae
Ranunculaceae	Ranunculaceae
Ficaria	Ranunculaceae
Ranunculus	Ranunculaceae
Rhamnaceae	Rhamnaceae
Paliurus	Rhamnaceae
Rosaceae	Rosaceae
Agrimonia	Rosaceae
Cotoneaster	Rosaceae
Crataegus	Rosaceae
Filipendula	Rosaceae
Malus	Rosaceae
Potentilla	Rosaceae
Prunus	Rosaceae
Pyrus	Rosaceae
Rosa	Rosaceae
Rubus	Rosaceae
Sanguisorba	Rosaceae
Sorbus	Rosaceae
Rubiaceae	Rubiaceae
Galium	Rubiaceae
Rutaceae	Rutaceae
Citrus	Rutaceae
Salicaceae	Salicaceae
Salix	Salicaceae
Scrophulariaceae	Scrophulariaceae
Verbascum	Scrophulariaceae
Tamaricaceae	Tamaricaceae
Tamarix	Tamaricaceae
Xanthorrhoeaceae	Xanthorrhoeaceae
Eremurus	Xanthorrhoeaceae
Zygophyllaceae	Zygophyllaceae
Tribulus	Zygophyllaceae
Muscari	Asparagaceae